Running greedy best first search
▗▄▄▄▄▄▄▄▄▄▄▄▄▄▄▄▄▄▄▄▄▄▄▄▄▄▄▄▄▄▄▄▖
▐04S┃R  ┃R  ┃R  ┃R  ┃R  ┃W  ┃R G▌
▐━━━╋━━━╋━━━╋━━━╋━━━╋━━━╋━━━╋━━━▌
▐R  ┃r  ┃r  ┃W  ┃W  ┃W  ┃F  ┃R  ▌
▐━━━╋━━━╋━━━╋━━━╋━━━╋━━━╋━━━╋━━━▌
▐R  ┃W  ┃M  ┃M  ┃M  ┃M  ┃M  ┃R  ▌
▐━━━╋━━━╋━━━╋━━━╋━━━╋━━━╋━━━╋━━━▌
▐R  ┃M  ┃W  ┃W  ┃W  ┃W  ┃W  ┃R  ▌
▐━━━╋━━━╋━━━╋━━━╋━━━╋━━━╋━━━╋━━━▌
▐R  ┃R  ┃R  ┃R  ┃R  ┃r  ┃R  ┃R  ▌
▝▀▀▀▀▀▀▀▀▀▀▀▀▀▀▀▀▀▀▀▀▀▀▀▀▀▀▀▀▀▀▀▘
▗▄▄▄▄▄▄▄▄▄▄▄▄▄▄▄▄▄▄▄▄▄▄▄▄▄▄▄▄▄▄▄▖
▐04S┃05◄┃R  ┃R  ┃R  ┃R  ┃W  ┃R G▌
▐━━━╋━━━╋━━━╋━━━╋━━━╋━━━╋━━━╋━━━▌
▐05▲┃r  ┃r  ┃W  ┃W  ┃W  ┃F  ┃R  ▌
▐━━━╋━━━╋━━━╋━━━╋━━━╋━━━╋━━━╋━━━▌
▐R  ┃W  ┃M  ┃M  ┃M  ┃M  ┃M  ┃R  ▌
▐━━━╋━━━╋━━━╋━━━╋━━━╋━━━╋━━━╋━━━▌
▐R  ┃M  ┃W  ┃W  ┃W  ┃W  ┃W  ┃R  ▌
▐━━━╋━━━╋━━━╋━━━╋━━━╋━━━╋━━━╋━━━▌
▐R  ┃R  ┃R  ┃R  ┃R  ┃r  ┃R  ┃R  ▌
▝▀▀▀▀▀▀▀▀▀▀▀▀▀▀▀▀▀▀▀▀▀▀▀▀▀▀▀▀▀▀▀▘
▗▄▄▄▄▄▄▄▄▄▄▄▄▄▄▄▄▄▄▄▄▄▄▄▄▄▄▄▄▄▄▄▖
▐04S┃05←┃06◄┃R  ┃R  ┃R  ┃W  ┃R G▌
▐━━━╋━━━╋━━━╋━━━╋━━━╋━━━╋━━━╋━━━▌
▐05▲┃12▲┃r  ┃W  ┃W  ┃W  ┃F  ┃R  ▌
▐━━━╋━━━╋━━━╋━━━╋━━━╋━━━╋━━━╋━━━▌
▐R  ┃W  ┃M  ┃M  ┃M  ┃M  ┃M  ┃R  ▌
▐━━━╋━━━╋━━━╋━━━╋━━━╋━━━╋━━━╋━━━▌
▐R  ┃M  ┃W  ┃W  ┃W  ┃W  ┃W  ┃R  ▌
▐━━━╋━━━╋━━━╋━━━╋━━━╋━━━╋━━━╋━━━▌
▐R  ┃R  ┃R  ┃R  ┃R  ┃r  ┃R  ┃R  ▌
▝▀▀▀▀▀▀▀▀▀▀▀▀▀▀▀▀▀▀▀▀▀▀▀▀▀▀▀▀▀▀▀▘
▗▄▄▄▄▄▄▄▄▄▄▄▄▄▄▄▄▄▄▄▄▄▄▄▄▄▄▄▄▄▄▄▖
▐04S┃05←┃06←┃07◄┃R  ┃R  ┃W  ┃R G▌
▐━━━╋━━━╋━━━╋━━━╋━━━╋━━━╋━━━╋━━━▌
▐05▲┃12▲┃13▲┃W  ┃W  ┃W  ┃F  ┃R  ▌
▐━━━╋━━━╋━━━╋━━━╋━━━╋━━━╋━━━╋━━━▌
▐R  ┃W  ┃M  ┃M  ┃M  ┃M  ┃M  ┃R  ▌
▐━━━╋━━━╋━━━╋━━━╋━━━╋━━━╋━━━╋━━━▌
▐R  ┃M  ┃W  ┃W  ┃W  ┃W  ┃W  ┃R  ▌
▐━━━╋━━━╋━━━╋━━━╋━━━╋━━━╋━━━╋━━━▌
▐R  ┃R  ┃R  ┃R  ┃R  ┃r  ┃R  ┃R  ▌
▝▀▀▀▀▀▀▀▀▀▀▀▀▀▀▀▀▀▀▀▀▀▀▀▀▀▀▀▀▀▀▀▘
▗▄▄▄▄▄▄▄▄▄▄▄▄▄▄▄▄▄▄▄▄▄▄▄▄▄▄▄▄▄▄▄▖
▐04S┃05←┃06←┃07←┃08◄┃R  ┃W  ┃R G▌
▐━━━╋━━━╋━━━╋━━━╋━━━╋━━━╋━━━╋━━━▌
▐05▲┃12▲┃13▲┃W  ┃W  ┃W  ┃F  ┃R  ▌
▐━━━╋━━━╋━━━╋━━━╋━━━╋━━━╋━━━╋━━━▌
▐R  ┃W  ┃M  ┃M  ┃M  ┃M  ┃M  ┃R  ▌
▐━━━╋━━━╋━━━╋━━━╋━━━╋━━━╋━━━╋━━━▌
▐R  ┃M  ┃W  ┃W  ┃W  ┃W  ┃W  ┃R  ▌
▐━━━╋━━━╋━━━╋━━━╋━━━╋━━━╋━━━╋━━━▌
▐R  ┃R  ┃R  ┃R  ┃R  ┃r  ┃R  ┃R  ▌
▝▀▀▀▀▀▀▀▀▀▀▀▀▀▀▀▀▀▀▀▀▀▀▀▀▀▀▀▀▀▀▀▘
▗▄▄▄▄▄▄▄▄▄▄▄▄▄▄▄▄▄▄▄▄▄▄▄▄▄▄▄▄▄▄▄▖
▐04S┃05←┃06←┃07←┃08←┃09◄┃W  ┃R G▌
▐━━━╋━━━╋━━━╋━━━╋━━━╋━━━╋━━━╋━━━▌
▐05▲┃12▲┃13▲┃W  ┃W  ┃W  ┃F  ┃R  ▌
▐━━━╋━━━╋━━━╋━━━╋━━━╋━━━╋━━━╋━━━▌
▐R  ┃W  ┃M  ┃M  ┃M  ┃M  ┃M  ┃R  ▌
▐━━━╋━━━╋━━━╋━━━╋━━━╋━━━╋━━━╋━━━▌
▐R  ┃M  ┃W  ┃W  ┃W  ┃W  ┃W  ┃R  ▌
▐━━━╋━━━╋━━━╋━━━╋━━━╋━━━╋━━━╋━━━▌
▐R  ┃R  ┃R  ┃R  ┃R  ┃r  ┃R  ┃R  ▌
▝▀▀▀▀▀▀▀▀▀▀▀▀▀▀▀▀▀▀▀▀▀▀▀▀▀▀▀▀▀▀▀▘
▗▄▄▄▄▄▄▄▄▄▄▄▄▄▄▄▄▄▄▄▄▄▄▄▄▄▄▄▄▄▄▄▖
▐04S┃05←┃06←┃07←┃08←┃09←┃W  ┃R G▌
▐━━━╋━━━╋━━━╋━━━╋━━━╋━━━╋━━━╋━━━▌
▐05▲┃12▲┃13▲┃W  ┃W  ┃W  ┃F  ┃R  ▌
▐━━━╋━━━╋━━━╋━━━╋━━━╋━━━╋━━━╋━━━▌
▐R  ┃W  ┃M  ┃M  ┃M  ┃M  ┃M  ┃R  ▌
▐━━━╋━━━╋━━━╋━━━╋━━━╋━━━╋━━━╋━━━▌
▐R  ┃M  ┃W  ┃W  ┃W  ┃W  ┃W  ┃R  ▌
▐━━━╋━━━╋━━━╋━━━╋━━━╋━━━╋━━━╋━━━▌
▐R  ┃R  ┃R  ┃R  ┃R  ┃r  ┃R  ┃R  ▌
▝▀▀▀▀▀▀▀▀▀▀▀▀▀▀▀▀▀▀▀▀▀▀▀▀▀▀▀▀▀▀▀▘
▗▄▄▄▄▄▄▄▄▄▄▄▄▄▄▄▄▄▄▄▄▄▄▄▄▄▄▄▄▄▄▄▖
▐04S┃05←┃06←┃07←┃08←┃09←┃W  ┃R G▌
▐━━━╋━━━╋━━━╋━━━╋━━━╋━━━╋━━━╋━━━▌
▐05▲┃12▲┃13↑┃W  ┃W  ┃W  ┃F  ┃R  ▌
▐━━━╋━━━╋━━━╋━━━╋━━━╋━━━╋━━━╋━━━▌
▐R  ┃W  ┃23▲┃M  ┃M  ┃M  ┃M  ┃R  ▌
▐━━━╋━━━╋━━━╋━━━╋━━━╋━━━╋━━━╋━━━▌
▐R  ┃M  ┃W  ┃W  ┃W  ┃W  ┃W  ┃R  ▌
▐━━━╋━━━╋━━━╋━━━╋━━━╋━━━╋━━━╋━━━▌
▐R  ┃R  ┃R  ┃R  ┃R  ┃r  ┃R  ┃R  ▌
▝▀▀▀▀▀▀▀▀▀▀▀▀▀▀▀▀▀▀▀▀▀▀▀▀▀▀▀▀▀▀▀▘
▗▄▄▄▄▄▄▄▄▄▄▄▄▄▄▄▄▄▄▄▄▄▄▄▄▄▄▄▄▄▄▄▖
▐04S┃05←┃06←┃07←┃08←┃09←┃W  ┃R G▌
▐━━━╋━━━╋━━━╋━━━╋━━━╋━━━╋━━━╋━━━▌
▐05▲┃12↑┃13↑┃W  ┃W  ┃W  ┃F  ┃R  ▌
▐━━━╋━━━╋━━━╋━━━╋━━━╋━━━╋━━━╋━━━▌
▐R  ┃W  ┃23▲┃M  ┃M  ┃M  ┃M  ┃R  ▌
▐━━━╋━━━╋━━━╋━━━╋━━━╋━━━╋━━━╋━━━▌
▐R  ┃M  ┃W  ┃W  ┃W  ┃W  ┃W  ┃R  ▌
▐━━━╋━━━╋━━━╋━━━╋━━━╋━━━╋━━━╋━━━▌
▐R  ┃R  ┃R  ┃R  ┃R  ┃r  ┃R  ┃R  ▌
▝▀▀▀▀▀▀▀▀▀▀▀▀▀▀▀▀▀▀▀▀▀▀▀▀▀▀▀▀▀▀▀▘
▗▄▄▄▄▄▄▄▄▄▄▄▄▄▄▄▄▄▄▄▄▄▄▄▄▄▄▄▄▄▄▄▖
▐04S┃05←┃06←┃07←┃08←┃09←┃W  ┃R G▌
▐━━━╋━━━╋━━━╋━━━╋━━━╋━━━╋━━━╋━━━▌
▐05▲┃12↑┃13↑┃W  ┃W  ┃W  ┃F  ┃R  ▌
▐━━━╋━━━╋━━━╋━━━╋━━━╋━━━╋━━━╋━━━▌
▐R  ┃W  ┃23↑┃33◄┃M  ┃M  ┃M  ┃R  ▌
▐━━━╋━━━╋━━━╋━━━╋━━━╋━━━╋━━━╋━━━▌
▐R  ┃M  ┃W  ┃W  ┃W  ┃W  ┃W  ┃R  ▌
▐━━━╋━━━╋━━━╋━━━╋━━━╋━━━╋━━━╋━━━▌
▐R  ┃R  ┃R  ┃R  ┃R  ┃r  ┃R  ┃R  ▌
▝▀▀▀▀▀▀▀▀▀▀▀▀▀▀▀▀▀▀▀▀▀▀▀▀▀▀▀▀▀▀▀▘
▗▄▄▄▄▄▄▄▄▄▄▄▄▄▄▄▄▄▄▄▄▄▄▄▄▄▄▄▄▄▄▄▖
▐04S┃05←┃06←┃07←┃08←┃09←┃W  ┃R G▌
▐━━━╋━━━╋━━━╋━━━╋━━━╋━━━╋━━━╋━━━▌
▐05▲┃12↑┃13↑┃W  ┃W  ┃W  ┃F  ┃R  ▌
▐━━━╋━━━╋━━━╋━━━╋━━━╋━━━╋━━━╋━━━▌
▐R  ┃W  ┃23↑┃33←┃43◄┃M  ┃M  ┃R  ▌
▐━━━╋━━━╋━━━╋━━━╋━━━╋━━━╋━━━╋━━━▌
▐R  ┃M  ┃W  ┃W  ┃W  ┃W  ┃W  ┃R  ▌
▐━━━╋━━━╋━━━╋━━━╋━━━╋━━━╋━━━╋━━━▌
▐R  ┃R  ┃R  ┃R  ┃R  ┃r  ┃R  ┃R  ▌
▝▀▀▀▀▀▀▀▀▀▀▀▀▀▀▀▀▀▀▀▀▀▀▀▀▀▀▀▀▀▀▀▘
▗▄▄▄▄▄▄▄▄▄▄▄▄▄▄▄▄▄▄▄▄▄▄▄▄▄▄▄▄▄▄▄▖
▐04S┃05←┃06←┃07←┃08←┃09←┃W  ┃R G▌
▐━━━╋━━━╋━━━╋━━━╋━━━╋━━━╋━━━╋━━━▌
▐05▲┃12↑┃13↑┃W  ┃W  ┃W  ┃F  ┃R  ▌
▐━━━╋━━━╋━━━╋━━━╋━━━╋━━━╋━━━╋━━━▌
▐R  ┃W  ┃23↑┃33←┃43←┃53◄┃M  ┃R  ▌
▐━━━╋━━━╋━━━╋━━━╋━━━╋━━━╋━━━╋━━━▌
▐R  ┃M  ┃W  ┃W  ┃W  ┃W  ┃W  ┃R  ▌
▐━━━╋━━━╋━━━╋━━━╋━━━╋━━━╋━━━╋━━━▌
▐R  ┃R  ┃R  ┃R  ┃R  ┃r  ┃R  ┃R  ▌
▝▀▀▀▀▀▀▀▀▀▀▀▀▀▀▀▀▀▀▀▀▀▀▀▀▀▀▀▀▀▀▀▘
▗▄▄▄▄▄▄▄▄▄▄▄▄▄▄▄▄▄▄▄▄▄▄▄▄▄▄▄▄▄▄▄▖
▐04S┃05←┃06←┃07←┃08←┃09←┃W  ┃R G▌
▐━━━╋━━━╋━━━╋━━━╋━━━╋━━━╋━━━╋━━━▌
▐05▲┃12↑┃13↑┃W  ┃W  ┃W  ┃F  ┃R  ▌
▐━━━╋━━━╋━━━╋━━━╋━━━╋━━━╋━━━╋━━━▌
▐R  ┃W  ┃23↑┃33←┃43←┃53←┃63◄┃R  ▌
▐━━━╋━━━╋━━━╋━━━╋━━━╋━━━╋━━━╋━━━▌
▐R  ┃M  ┃W  ┃W  ┃W  ┃W  ┃W  ┃R  ▌
▐━━━╋━━━╋━━━╋━━━╋━━━╋━━━╋━━━╋━━━▌
▐R  ┃R  ┃R  ┃R  ┃R  ┃r  ┃R  ┃R  ▌
▝▀▀▀▀▀▀▀▀▀▀▀▀▀▀▀▀▀▀▀▀▀▀▀▀▀▀▀▀▀▀▀▘
▗▄▄▄▄▄▄▄▄▄▄▄▄▄▄▄▄▄▄▄▄▄▄▄▄▄▄▄▄▄▄▄▖
▐04S┃05←┃06←┃07←┃08←┃09←┃W  ┃R G▌
▐━━━╋━━━╋━━━╋━━━╋━━━╋━━━╋━━━╋━━━▌
▐05▲┃12↑┃13↑┃W  ┃W  ┃W  ┃67▼┃R  ▌
▐━━━╋━━━╋━━━╋━━━╋━━━╋━━━╋━━━╋━━━▌
▐R  ┃W  ┃23↑┃33←┃43←┃53←┃63←┃64◄▌
▐━━━╋━━━╋━━━╋━━━╋━━━╋━━━╋━━━╋━━━▌
▐R  ┃M  ┃W  ┃W  ┃W  ┃W  ┃W  ┃R  ▌
▐━━━╋━━━╋━━━╋━━━╋━━━╋━━━╋━━━╋━━━▌
▐R  ┃R  ┃R  ┃R  ┃R  ┃r  ┃R  ┃R  ▌
▝▀▀▀▀▀▀▀▀▀▀▀▀▀▀▀▀▀▀▀▀▀▀▀▀▀▀▀▀▀▀▀▘
▗▄▄▄▄▄▄▄▄▄▄▄▄▄▄▄▄▄▄▄▄▄▄▄▄▄▄▄▄▄▄▄▖
▐04S┃05←┃06←┃07←┃08←┃09←┃W  ┃R G▌
▐━━━╋━━━╋━━━╋━━━╋━━━╋━━━╋━━━╋━━━▌
▐05▲┃12↑┃13↑┃W  ┃W  ┃W  ┃67↓┃68◄▌
▐━━━╋━━━╋━━━╋━━━╋━━━╋━━━╋━━━╋━━━▌
▐R  ┃W  ┃23↑┃33←┃43←┃53←┃63←┃64◄▌
▐━━━╋━━━╋━━━╋━━━╋━━━╋━━━╋━━━╋━━━▌
▐R  ┃M  ┃W  ┃W  ┃W  ┃W  ┃W  ┃R  ▌
▐━━━╋━━━╋━━━╋━━━╋━━━╋━━━╋━━━╋━━━▌
▐R  ┃R  ┃R  ┃R  ┃R  ┃r  ┃R  ┃R  ▌
▝▀▀▀▀▀▀▀▀▀▀▀▀▀▀▀▀▀▀▀▀▀▀▀▀▀▀▀▀▀▀▀▘
▗▄▄▄▄▄▄▄▄▄▄▄▄▄▄▄▄▄▄▄▄▄▄▄▄▄▄▄▄▄▄▄▖
▐04S┃05←┃06←┃07←┃08←┃09←┃W  ┃69↓▌
▐━━━╋━━━╋━━━╋━━━╋━━━╋━━━╋━━━╋━━━▌
▐05↑┃12↑┃13↑┃W  ┃W  ┃W  ┃67↓┃68←▌
▐━━━╋━━━╋━━━╋━━━╋━━━╋━━━╋━━━╋━━━▌
▐R  ┃W  ┃23↑┃33←┃43←┃53←┃63←┃64←▌
▐━━━╋━━━╋━━━╋━━━╋━━━╋━━━╋━━━╋━━━▌
▐R  ┃M  ┃W  ┃W  ┃W  ┃W  ┃W  ┃R  ▌
▐━━━╋━━━╋━━━╋━━━╋━━━╋━━━╋━━━╋━━━▌
▐R  ┃R  ┃R  ┃R  ┃R  ┃r  ┃R  ┃R  ▌
▝▀▀▀▀▀▀▀▀▀▀▀▀▀▀▀▀▀▀▀▀▀▀▀▀▀▀▀▀▀▀▀▘
Doing backtracking
▗▄▄▄▄▄▄▄▄▄▄▄▄▄▄▄▄▄▄▄▄▄▄▄▄▄▄▄▄▄▄▄▖
▐04S┃05←┃06←┃07←┃08←┃09←┃W  ┃69█▌
▐━━━╋━━━╋━━━╋━━━╋━━━╋━━━╋━━━╋━━━▌
▐05↑┃12↑┃13↑┃W  ┃W  ┃W  ┃67↓┃68←▌
▐━━━╋━━━╋━━━╋━━━╋━━━╋━━━╋━━━╋━━━▌
▐R  ┃W  ┃23↑┃33←┃43←┃53←┃63←┃64←▌
▐━━━╋━━━╋━━━╋━━━╋━━━╋━━━╋━━━╋━━━▌
▐R  ┃M  ┃W  ┃W  ┃W  ┃W  ┃W  ┃R  ▌
▐━━━╋━━━╋━━━╋━━━╋━━━╋━━━╋━━━╋━━━▌
▐R  ┃R  ┃R  ┃R  ┃R  ┃r  ┃R  ┃R  ▌
▝▀▀▀▀▀▀▀▀▀▀▀▀▀▀▀▀▀▀▀▀▀▀▀▀▀▀▀▀▀▀▀▘
▗▄▄▄▄▄▄▄▄▄▄▄▄▄▄▄▄▄▄▄▄▄▄▄▄▄▄▄▄▄▄▄▖
▐04S┃05←┃06←┃07←┃08←┃09←┃W  ┃69█▌
▐━━━╋━━━╋━━━╋━━━╋━━━╋━━━╋━━━╋━━━▌
▐05↑┃12↑┃13↑┃W  ┃W  ┃W  ┃67↓┃68█▌
▐━━━╋━━━╋━━━╋━━━╋━━━╋━━━╋━━━╋━━━▌
▐R  ┃W  ┃23↑┃33←┃43←┃53←┃63←┃64←▌
▐━━━╋━━━╋━━━╋━━━╋━━━╋━━━╋━━━╋━━━▌
▐R  ┃M  ┃W  ┃W  ┃W  ┃W  ┃W  ┃R  ▌
▐━━━╋━━━╋━━━╋━━━╋━━━╋━━━╋━━━╋━━━▌
▐R  ┃R  ┃R  ┃R  ┃R  ┃r  ┃R  ┃R  ▌
▝▀▀▀▀▀▀▀▀▀▀▀▀▀▀▀▀▀▀▀▀▀▀▀▀▀▀▀▀▀▀▀▘
▗▄▄▄▄▄▄▄▄▄▄▄▄▄▄▄▄▄▄▄▄▄▄▄▄▄▄▄▄▄▄▄▖
▐04S┃05←┃06←┃07←┃08←┃09←┃W  ┃69█▌
▐━━━╋━━━╋━━━╋━━━╋━━━╋━━━╋━━━╋━━━▌
▐05↑┃12↑┃13↑┃W  ┃W  ┃W  ┃67█┃68█▌
▐━━━╋━━━╋━━━╋━━━╋━━━╋━━━╋━━━╋━━━▌
▐R  ┃W  ┃23↑┃33←┃43←┃53←┃63←┃64←▌
▐━━━╋━━━╋━━━╋━━━╋━━━╋━━━╋━━━╋━━━▌
▐R  ┃M  ┃W  ┃W  ┃W  ┃W  ┃W  ┃R  ▌
▐━━━╋━━━╋━━━╋━━━╋━━━╋━━━╋━━━╋━━━▌
▐R  ┃R  ┃R  ┃R  ┃R  ┃r  ┃R  ┃R  ▌
▝▀▀▀▀▀▀▀▀▀▀▀▀▀▀▀▀▀▀▀▀▀▀▀▀▀▀▀▀▀▀▀▘
▗▄▄▄▄▄▄▄▄▄▄▄▄▄▄▄▄▄▄▄▄▄▄▄▄▄▄▄▄▄▄▄▖
▐04S┃05←┃06←┃07←┃08←┃09←┃W  ┃69█▌
▐━━━╋━━━╋━━━╋━━━╋━━━╋━━━╋━━━╋━━━▌
▐05↑┃12↑┃13↑┃W  ┃W  ┃W  ┃67█┃68█▌
▐━━━╋━━━╋━━━╋━━━╋━━━╋━━━╋━━━╋━━━▌
▐R  ┃W  ┃23↑┃33←┃43←┃53←┃63█┃64←▌
▐━━━╋━━━╋━━━╋━━━╋━━━╋━━━╋━━━╋━━━▌
▐R  ┃M  ┃W  ┃W  ┃W  ┃W  ┃W  ┃R  ▌
▐━━━╋━━━╋━━━╋━━━╋━━━╋━━━╋━━━╋━━━▌
▐R  ┃R  ┃R  ┃R  ┃R  ┃r  ┃R  ┃R  ▌
▝▀▀▀▀▀▀▀▀▀▀▀▀▀▀▀▀▀▀▀▀▀▀▀▀▀▀▀▀▀▀▀▘
▗▄▄▄▄▄▄▄▄▄▄▄▄▄▄▄▄▄▄▄▄▄▄▄▄▄▄▄▄▄▄▄▖
▐04S┃05←┃06←┃07←┃08←┃09←┃W  ┃69█▌
▐━━━╋━━━╋━━━╋━━━╋━━━╋━━━╋━━━╋━━━▌
▐05↑┃12↑┃13↑┃W  ┃W  ┃W  ┃67█┃68█▌
▐━━━╋━━━╋━━━╋━━━╋━━━╋━━━╋━━━╋━━━▌
▐R  ┃W  ┃23↑┃33←┃43←┃53█┃63█┃64←▌
▐━━━╋━━━╋━━━╋━━━╋━━━╋━━━╋━━━╋━━━▌
▐R  ┃M  ┃W  ┃W  ┃W  ┃W  ┃W  ┃R  ▌
▐━━━╋━━━╋━━━╋━━━╋━━━╋━━━╋━━━╋━━━▌
▐R  ┃R  ┃R  ┃R  ┃R  ┃r  ┃R  ┃R  ▌
▝▀▀▀▀▀▀▀▀▀▀▀▀▀▀▀▀▀▀▀▀▀▀▀▀▀▀▀▀▀▀▀▘
▗▄▄▄▄▄▄▄▄▄▄▄▄▄▄▄▄▄▄▄▄▄▄▄▄▄▄▄▄▄▄▄▖
▐04S┃05←┃06←┃07←┃08←┃09←┃W  ┃69█▌
▐━━━╋━━━╋━━━╋━━━╋━━━╋━━━╋━━━╋━━━▌
▐05↑┃12↑┃13↑┃W  ┃W  ┃W  ┃67█┃68█▌
▐━━━╋━━━╋━━━╋━━━╋━━━╋━━━╋━━━╋━━━▌
▐R  ┃W  ┃23↑┃33←┃43█┃53█┃63█┃64←▌
▐━━━╋━━━╋━━━╋━━━╋━━━╋━━━╋━━━╋━━━▌
▐R  ┃M  ┃W  ┃W  ┃W  ┃W  ┃W  ┃R  ▌
▐━━━╋━━━╋━━━╋━━━╋━━━╋━━━╋━━━╋━━━▌
▐R  ┃R  ┃R  ┃R  ┃R  ┃r  ┃R  ┃R  ▌
▝▀▀▀▀▀▀▀▀▀▀▀▀▀▀▀▀▀▀▀▀▀▀▀▀▀▀▀▀▀▀▀▘
▗▄▄▄▄▄▄▄▄▄▄▄▄▄▄▄▄▄▄▄▄▄▄▄▄▄▄▄▄▄▄▄▖
▐04S┃05←┃06←┃07←┃08←┃09←┃W  ┃69█▌
▐━━━╋━━━╋━━━╋━━━╋━━━╋━━━╋━━━╋━━━▌
▐05↑┃12↑┃13↑┃W  ┃W  ┃W  ┃67█┃68█▌
▐━━━╋━━━╋━━━╋━━━╋━━━╋━━━╋━━━╋━━━▌
▐R  ┃W  ┃23↑┃33█┃43█┃53█┃63█┃64←▌
▐━━━╋━━━╋━━━╋━━━╋━━━╋━━━╋━━━╋━━━▌
▐R  ┃M  ┃W  ┃W  ┃W  ┃W  ┃W  ┃R  ▌
▐━━━╋━━━╋━━━╋━━━╋━━━╋━━━╋━━━╋━━━▌
▐R  ┃R  ┃R  ┃R  ┃R  ┃r  ┃R  ┃R  ▌
▝▀▀▀▀▀▀▀▀▀▀▀▀▀▀▀▀▀▀▀▀▀▀▀▀▀▀▀▀▀▀▀▘
▗▄▄▄▄▄▄▄▄▄▄▄▄▄▄▄▄▄▄▄▄▄▄▄▄▄▄▄▄▄▄▄▖
▐04S┃05←┃06←┃07←┃08←┃09←┃W  ┃69█▌
▐━━━╋━━━╋━━━╋━━━╋━━━╋━━━╋━━━╋━━━▌
▐05↑┃12↑┃13↑┃W  ┃W  ┃W  ┃67█┃68█▌
▐━━━╋━━━╋━━━╋━━━╋━━━╋━━━╋━━━╋━━━▌
▐R  ┃W  ┃23█┃33█┃43█┃53█┃63█┃64←▌
▐━━━╋━━━╋━━━╋━━━╋━━━╋━━━╋━━━╋━━━▌
▐R  ┃M  ┃W  ┃W  ┃W  ┃W  ┃W  ┃R  ▌
▐━━━╋━━━╋━━━╋━━━╋━━━╋━━━╋━━━╋━━━▌
▐R  ┃R  ┃R  ┃R  ┃R  ┃r  ┃R  ┃R  ▌
▝▀▀▀▀▀▀▀▀▀▀▀▀▀▀▀▀▀▀▀▀▀▀▀▀▀▀▀▀▀▀▀▘
▗▄▄▄▄▄▄▄▄▄▄▄▄▄▄▄▄▄▄▄▄▄▄▄▄▄▄▄▄▄▄▄▖
▐04S┃05←┃06←┃07←┃08←┃09←┃W  ┃69█▌
▐━━━╋━━━╋━━━╋━━━╋━━━╋━━━╋━━━╋━━━▌
▐05↑┃12↑┃13█┃W  ┃W  ┃W  ┃67█┃68█▌
▐━━━╋━━━╋━━━╋━━━╋━━━╋━━━╋━━━╋━━━▌
▐R  ┃W  ┃23█┃33█┃43█┃53█┃63█┃64←▌
▐━━━╋━━━╋━━━╋━━━╋━━━╋━━━╋━━━╋━━━▌
▐R  ┃M  ┃W  ┃W  ┃W  ┃W  ┃W  ┃R  ▌
▐━━━╋━━━╋━━━╋━━━╋━━━╋━━━╋━━━╋━━━▌
▐R  ┃R  ┃R  ┃R  ┃R  ┃r  ┃R  ┃R  ▌
▝▀▀▀▀▀▀▀▀▀▀▀▀▀▀▀▀▀▀▀▀▀▀▀▀▀▀▀▀▀▀▀▘
▗▄▄▄▄▄▄▄▄▄▄▄▄▄▄▄▄▄▄▄▄▄▄▄▄▄▄▄▄▄▄▄▖
▐04S┃05←┃06█┃07←┃08←┃09←┃W  ┃69█▌
▐━━━╋━━━╋━━━╋━━━╋━━━╋━━━╋━━━╋━━━▌
▐05↑┃12↑┃13█┃W  ┃W  ┃W  ┃67█┃68█▌
▐━━━╋━━━╋━━━╋━━━╋━━━╋━━━╋━━━╋━━━▌
▐R  ┃W  ┃23█┃33█┃43█┃53█┃63█┃64←▌
▐━━━╋━━━╋━━━╋━━━╋━━━╋━━━╋━━━╋━━━▌
▐R  ┃M  ┃W  ┃W  ┃W  ┃W  ┃W  ┃R  ▌
▐━━━╋━━━╋━━━╋━━━╋━━━╋━━━╋━━━╋━━━▌
▐R  ┃R  ┃R  ┃R  ┃R  ┃r  ┃R  ┃R  ▌
▝▀▀▀▀▀▀▀▀▀▀▀▀▀▀▀▀▀▀▀▀▀▀▀▀▀▀▀▀▀▀▀▘
▗▄▄▄▄▄▄▄▄▄▄▄▄▄▄▄▄▄▄▄▄▄▄▄▄▄▄▄▄▄▄▄▖
▐04S┃05█┃06█┃07←┃08←┃09←┃W  ┃69█▌
▐━━━╋━━━╋━━━╋━━━╋━━━╋━━━╋━━━╋━━━▌
▐05↑┃12↑┃13█┃W  ┃W  ┃W  ┃67█┃68█▌
▐━━━╋━━━╋━━━╋━━━╋━━━╋━━━╋━━━╋━━━▌
▐R  ┃W  ┃23█┃33█┃43█┃53█┃63█┃64←▌
▐━━━╋━━━╋━━━╋━━━╋━━━╋━━━╋━━━╋━━━▌
▐R  ┃M  ┃W  ┃W  ┃W  ┃W  ┃W  ┃R  ▌
▐━━━╋━━━╋━━━╋━━━╋━━━╋━━━╋━━━╋━━━▌
▐R  ┃R  ┃R  ┃R  ┃R  ┃r  ┃R  ┃R  ▌
▝▀▀▀▀▀▀▀▀▀▀▀▀▀▀▀▀▀▀▀▀▀▀▀▀▀▀▀▀▀▀▀▘
▗▄▄▄▄▄▄▄▄▄▄▄▄▄▄▄▄▄▄▄▄▄▄▄▄▄▄▄▄▄▄▄▖
▐F█S┃R█ ┃R█ ┃R← ┃R← ┃R← ┃W  ┃R█G▌
▐━━━╋━━━╋━━━╋━━━╋━━━╋━━━╋━━━╋━━━▌
▐R↑ ┃r↑ ┃r█ ┃W  ┃W  ┃W  ┃F█ ┃R█ ▌
▐━━━╋━━━╋━━━╋━━━╋━━━╋━━━╋━━━╋━━━▌
▐R  ┃W  ┃M█ ┃M█ ┃M█ ┃M█ ┃M█ ┃R← ▌
▐━━━╋━━━╋━━━╋━━━╋━━━╋━━━╋━━━╋━━━▌
▐R  ┃M  ┃W  ┃W  ┃W  ┃W  ┃W  ┃R  ▌
▐━━━╋━━━╋━━━╋━━━╋━━━╋━━━╋━━━╋━━━▌
▐R  ┃R  ┃R  ┃R  ┃R  ┃r  ┃R  ┃R  ▌
▝▀▀▀▀▀▀▀▀▀▀▀▀▀▀▀▀▀▀▀▀▀▀▀▀▀▀▀▀▀▀▀▘
Path found (dist: 12 cost: 69 iterations: 18) by greedy best first alg
