8 5
0 0
7 0
FRRRRRWR
RrrWWWFR
RWMMMMMR
RMWWWWWR
RRRRRrRR
