Running lowest cost search
▗▄▄▄▄▄▄▄▄▄▄▄▄▄▄▄▄▄▄▄▖
▐F G┃M  ┃M  ┃M  ┃04S▌
▐━━━╋━━━╋━━━╋━━━╋━━━▌
▐f  ┃W  ┃W  ┃W  ┃f  ▌
▐━━━╋━━━╋━━━╋━━━╋━━━▌
▐f  ┃W  ┃W  ┃W  ┃f  ▌
▐━━━╋━━━╋━━━╋━━━╋━━━▌
▐f  ┃f  ┃f  ┃f  ┃f  ▌
▝▀▀▀▀▀▀▀▀▀▀▀▀▀▀▀▀▀▀▀▘
▗▄▄▄▄▄▄▄▄▄▄▄▄▄▄▄▄▄▄▄▖
▐F G┃M  ┃M  ┃14►┃04S▌
▐━━━╋━━━╋━━━╋━━━╋━━━▌
▐f  ┃W  ┃W  ┃W  ┃06▲▌
▐━━━╋━━━╋━━━╋━━━╋━━━▌
▐f  ┃W  ┃W  ┃W  ┃f  ▌
▐━━━╋━━━╋━━━╋━━━╋━━━▌
▐f  ┃f  ┃f  ┃f  ┃f  ▌
▝▀▀▀▀▀▀▀▀▀▀▀▀▀▀▀▀▀▀▀▘
▗▄▄▄▄▄▄▄▄▄▄▄▄▄▄▄▄▄▄▄▖
▐F G┃M  ┃M  ┃14►┃04S▌
▐━━━╋━━━╋━━━╋━━━╋━━━▌
▐f  ┃W  ┃W  ┃W  ┃06↑▌
▐━━━╋━━━╋━━━╋━━━╋━━━▌
▐f  ┃W  ┃W  ┃W  ┃08▲▌
▐━━━╋━━━╋━━━╋━━━╋━━━▌
▐f  ┃f  ┃f  ┃f  ┃f  ▌
▝▀▀▀▀▀▀▀▀▀▀▀▀▀▀▀▀▀▀▀▘
▗▄▄▄▄▄▄▄▄▄▄▄▄▄▄▄▄▄▄▄▖
▐F G┃M  ┃M  ┃14►┃04S▌
▐━━━╋━━━╋━━━╋━━━╋━━━▌
▐f  ┃W  ┃W  ┃W  ┃06↑▌
▐━━━╋━━━╋━━━╋━━━╋━━━▌
▐f  ┃W  ┃W  ┃W  ┃08↑▌
▐━━━╋━━━╋━━━╋━━━╋━━━▌
▐f  ┃f  ┃f  ┃f  ┃10▲▌
▝▀▀▀▀▀▀▀▀▀▀▀▀▀▀▀▀▀▀▀▘
▗▄▄▄▄▄▄▄▄▄▄▄▄▄▄▄▄▄▄▄▖
▐F G┃M  ┃M  ┃14►┃04S▌
▐━━━╋━━━╋━━━╋━━━╋━━━▌
▐f  ┃W  ┃W  ┃W  ┃06↑▌
▐━━━╋━━━╋━━━╋━━━╋━━━▌
▐f  ┃W  ┃W  ┃W  ┃08↑▌
▐━━━╋━━━╋━━━╋━━━╋━━━▌
▐f  ┃f  ┃f  ┃12►┃10↑▌
▝▀▀▀▀▀▀▀▀▀▀▀▀▀▀▀▀▀▀▀▘
▗▄▄▄▄▄▄▄▄▄▄▄▄▄▄▄▄▄▄▄▖
▐F G┃M  ┃M  ┃14►┃04S▌
▐━━━╋━━━╋━━━╋━━━╋━━━▌
▐f  ┃W  ┃W  ┃W  ┃06↑▌
▐━━━╋━━━╋━━━╋━━━╋━━━▌
▐f  ┃W  ┃W  ┃W  ┃08↑▌
▐━━━╋━━━╋━━━╋━━━╋━━━▌
▐f  ┃f  ┃14►┃12→┃10↑▌
▝▀▀▀▀▀▀▀▀▀▀▀▀▀▀▀▀▀▀▀▘
▗▄▄▄▄▄▄▄▄▄▄▄▄▄▄▄▄▄▄▄▖
▐F G┃M  ┃24►┃14→┃04S▌
▐━━━╋━━━╋━━━╋━━━╋━━━▌
▐f  ┃W  ┃W  ┃W  ┃06↑▌
▐━━━╋━━━╋━━━╋━━━╋━━━▌
▐f  ┃W  ┃W  ┃W  ┃08↑▌
▐━━━╋━━━╋━━━╋━━━╋━━━▌
▐f  ┃f  ┃14►┃12→┃10↑▌
▝▀▀▀▀▀▀▀▀▀▀▀▀▀▀▀▀▀▀▀▘
▗▄▄▄▄▄▄▄▄▄▄▄▄▄▄▄▄▄▄▄▖
▐F G┃M  ┃24►┃14→┃04S▌
▐━━━╋━━━╋━━━╋━━━╋━━━▌
▐f  ┃W  ┃W  ┃W  ┃06↑▌
▐━━━╋━━━╋━━━╋━━━╋━━━▌
▐f  ┃W  ┃W  ┃W  ┃08↑▌
▐━━━╋━━━╋━━━╋━━━╋━━━▌
▐f  ┃16►┃14→┃12→┃10↑▌
▝▀▀▀▀▀▀▀▀▀▀▀▀▀▀▀▀▀▀▀▘
▗▄▄▄▄▄▄▄▄▄▄▄▄▄▄▄▄▄▄▄▖
▐F G┃M  ┃24►┃14→┃04S▌
▐━━━╋━━━╋━━━╋━━━╋━━━▌
▐f  ┃W  ┃W  ┃W  ┃06↑▌
▐━━━╋━━━╋━━━╋━━━╋━━━▌
▐f  ┃W  ┃W  ┃W  ┃08↑▌
▐━━━╋━━━╋━━━╋━━━╋━━━▌
▐18►┃16→┃14→┃12→┃10↑▌
▝▀▀▀▀▀▀▀▀▀▀▀▀▀▀▀▀▀▀▀▘
▗▄▄▄▄▄▄▄▄▄▄▄▄▄▄▄▄▄▄▄▖
▐F G┃M  ┃24►┃14→┃04S▌
▐━━━╋━━━╋━━━╋━━━╋━━━▌
▐f  ┃W  ┃W  ┃W  ┃06↑▌
▐━━━╋━━━╋━━━╋━━━╋━━━▌
▐20▼┃W  ┃W  ┃W  ┃08↑▌
▐━━━╋━━━╋━━━╋━━━╋━━━▌
▐18→┃16→┃14→┃12→┃10↑▌
▝▀▀▀▀▀▀▀▀▀▀▀▀▀▀▀▀▀▀▀▘
▗▄▄▄▄▄▄▄▄▄▄▄▄▄▄▄▄▄▄▄▖
▐F G┃M  ┃24►┃14→┃04S▌
▐━━━╋━━━╋━━━╋━━━╋━━━▌
▐22▼┃W  ┃W  ┃W  ┃06↑▌
▐━━━╋━━━╋━━━╋━━━╋━━━▌
▐20↓┃W  ┃W  ┃W  ┃08↑▌
▐━━━╋━━━╋━━━╋━━━╋━━━▌
▐18→┃16→┃14→┃12→┃10↑▌
▝▀▀▀▀▀▀▀▀▀▀▀▀▀▀▀▀▀▀▀▘
▗▄▄▄▄▄▄▄▄▄▄▄▄▄▄▄▄▄▄▄▖
▐26↓┃M  ┃24→┃14→┃04S▌
▐━━━╋━━━╋━━━╋━━━╋━━━▌
▐22↓┃W  ┃W  ┃W  ┃06↑▌
▐━━━╋━━━╋━━━╋━━━╋━━━▌
▐20↓┃W  ┃W  ┃W  ┃08↑▌
▐━━━╋━━━╋━━━╋━━━╋━━━▌
▐18→┃16→┃14→┃12→┃10↑▌
▝▀▀▀▀▀▀▀▀▀▀▀▀▀▀▀▀▀▀▀▘
Doing backtracking
▗▄▄▄▄▄▄▄▄▄▄▄▄▄▄▄▄▄▄▄▖
▐26█┃M  ┃24→┃14→┃04S▌
▐━━━╋━━━╋━━━╋━━━╋━━━▌
▐22↓┃W  ┃W  ┃W  ┃06↑▌
▐━━━╋━━━╋━━━╋━━━╋━━━▌
▐20↓┃W  ┃W  ┃W  ┃08↑▌
▐━━━╋━━━╋━━━╋━━━╋━━━▌
▐18→┃16→┃14→┃12→┃10↑▌
▝▀▀▀▀▀▀▀▀▀▀▀▀▀▀▀▀▀▀▀▘
▗▄▄▄▄▄▄▄▄▄▄▄▄▄▄▄▄▄▄▄▖
▐26█┃M  ┃24→┃14→┃04S▌
▐━━━╋━━━╋━━━╋━━━╋━━━▌
▐22█┃W  ┃W  ┃W  ┃06↑▌
▐━━━╋━━━╋━━━╋━━━╋━━━▌
▐20↓┃W  ┃W  ┃W  ┃08↑▌
▐━━━╋━━━╋━━━╋━━━╋━━━▌
▐18→┃16→┃14→┃12→┃10↑▌
▝▀▀▀▀▀▀▀▀▀▀▀▀▀▀▀▀▀▀▀▘
▗▄▄▄▄▄▄▄▄▄▄▄▄▄▄▄▄▄▄▄▖
▐26█┃M  ┃24→┃14→┃04S▌
▐━━━╋━━━╋━━━╋━━━╋━━━▌
▐22█┃W  ┃W  ┃W  ┃06↑▌
▐━━━╋━━━╋━━━╋━━━╋━━━▌
▐20█┃W  ┃W  ┃W  ┃08↑▌
▐━━━╋━━━╋━━━╋━━━╋━━━▌
▐18→┃16→┃14→┃12→┃10↑▌
▝▀▀▀▀▀▀▀▀▀▀▀▀▀▀▀▀▀▀▀▘
▗▄▄▄▄▄▄▄▄▄▄▄▄▄▄▄▄▄▄▄▖
▐26█┃M  ┃24→┃14→┃04S▌
▐━━━╋━━━╋━━━╋━━━╋━━━▌
▐22█┃W  ┃W  ┃W  ┃06↑▌
▐━━━╋━━━╋━━━╋━━━╋━━━▌
▐20█┃W  ┃W  ┃W  ┃08↑▌
▐━━━╋━━━╋━━━╋━━━╋━━━▌
▐18█┃16→┃14→┃12→┃10↑▌
▝▀▀▀▀▀▀▀▀▀▀▀▀▀▀▀▀▀▀▀▘
▗▄▄▄▄▄▄▄▄▄▄▄▄▄▄▄▄▄▄▄▖
▐26█┃M  ┃24→┃14→┃04S▌
▐━━━╋━━━╋━━━╋━━━╋━━━▌
▐22█┃W  ┃W  ┃W  ┃06↑▌
▐━━━╋━━━╋━━━╋━━━╋━━━▌
▐20█┃W  ┃W  ┃W  ┃08↑▌
▐━━━╋━━━╋━━━╋━━━╋━━━▌
▐18█┃16█┃14→┃12→┃10↑▌
▝▀▀▀▀▀▀▀▀▀▀▀▀▀▀▀▀▀▀▀▘
▗▄▄▄▄▄▄▄▄▄▄▄▄▄▄▄▄▄▄▄▖
▐26█┃M  ┃24→┃14→┃04S▌
▐━━━╋━━━╋━━━╋━━━╋━━━▌
▐22█┃W  ┃W  ┃W  ┃06↑▌
▐━━━╋━━━╋━━━╋━━━╋━━━▌
▐20█┃W  ┃W  ┃W  ┃08↑▌
▐━━━╋━━━╋━━━╋━━━╋━━━▌
▐18█┃16█┃14█┃12→┃10↑▌
▝▀▀▀▀▀▀▀▀▀▀▀▀▀▀▀▀▀▀▀▘
▗▄▄▄▄▄▄▄▄▄▄▄▄▄▄▄▄▄▄▄▖
▐26█┃M  ┃24→┃14→┃04S▌
▐━━━╋━━━╋━━━╋━━━╋━━━▌
▐22█┃W  ┃W  ┃W  ┃06↑▌
▐━━━╋━━━╋━━━╋━━━╋━━━▌
▐20█┃W  ┃W  ┃W  ┃08↑▌
▐━━━╋━━━╋━━━╋━━━╋━━━▌
▐18█┃16█┃14█┃12█┃10↑▌
▝▀▀▀▀▀▀▀▀▀▀▀▀▀▀▀▀▀▀▀▘
▗▄▄▄▄▄▄▄▄▄▄▄▄▄▄▄▄▄▄▄▖
▐26█┃M  ┃24→┃14→┃04S▌
▐━━━╋━━━╋━━━╋━━━╋━━━▌
▐22█┃W  ┃W  ┃W  ┃06↑▌
▐━━━╋━━━╋━━━╋━━━╋━━━▌
▐20█┃W  ┃W  ┃W  ┃08↑▌
▐━━━╋━━━╋━━━╋━━━╋━━━▌
▐18█┃16█┃14█┃12█┃10█▌
▝▀▀▀▀▀▀▀▀▀▀▀▀▀▀▀▀▀▀▀▘
▗▄▄▄▄▄▄▄▄▄▄▄▄▄▄▄▄▄▄▄▖
▐26█┃M  ┃24→┃14→┃04S▌
▐━━━╋━━━╋━━━╋━━━╋━━━▌
▐22█┃W  ┃W  ┃W  ┃06↑▌
▐━━━╋━━━╋━━━╋━━━╋━━━▌
▐20█┃W  ┃W  ┃W  ┃08█▌
▐━━━╋━━━╋━━━╋━━━╋━━━▌
▐18█┃16█┃14█┃12█┃10█▌
▝▀▀▀▀▀▀▀▀▀▀▀▀▀▀▀▀▀▀▀▘
▗▄▄▄▄▄▄▄▄▄▄▄▄▄▄▄▄▄▄▄▖
▐26█┃M  ┃24→┃14→┃04S▌
▐━━━╋━━━╋━━━╋━━━╋━━━▌
▐22█┃W  ┃W  ┃W  ┃06█▌
▐━━━╋━━━╋━━━╋━━━╋━━━▌
▐20█┃W  ┃W  ┃W  ┃08█▌
▐━━━╋━━━╋━━━╋━━━╋━━━▌
▐18█┃16█┃14█┃12█┃10█▌
▝▀▀▀▀▀▀▀▀▀▀▀▀▀▀▀▀▀▀▀▘
▗▄▄▄▄▄▄▄▄▄▄▄▄▄▄▄▄▄▄▄▖
▐F█G┃M  ┃M→ ┃M→ ┃F█S▌
▐━━━╋━━━╋━━━╋━━━╋━━━▌
▐f█ ┃W  ┃W  ┃W  ┃f█ ▌
▐━━━╋━━━╋━━━╋━━━╋━━━▌
▐f█ ┃W  ┃W  ┃W  ┃f█ ▌
▐━━━╋━━━╋━━━╋━━━╋━━━▌
▐f█ ┃f█ ┃f█ ┃f█ ┃f█ ▌
▝▀▀▀▀▀▀▀▀▀▀▀▀▀▀▀▀▀▀▀▘
Path found (dist: 11 cost: 26 iterations: 13) by lowest cost alg
